1111111111111
1000001000101
1011101010101
1010001010101
1011101010101
1000101010101
1110101010101
1000101010101
1011101011101
1000101010001
1010111011101
1010000000001
1111111111111
