1111111111111
1000120000001
1010101111101
1010101010001
1010101011111
1010101200101
1010101010101
1010100010021
1010111110111
1010100212111
1010101010111
1010001000021
1111111111111
